33
    ##
   #g #
 ### l #
# k#ooo#
#so so #
# #s  p#
#H##h##
#hHhH#
 ####