25
 #$$$$#
 #    $$#
#$s#ee  #
# e##OOo#
#  ## e #
#p ## s #
$$$$#g s#
    $$$$$