24
 # ###
#p#k o##
# oeO l #
#o o oo g#
# o o oo #
 # o o ##
  #####