22
    ##
 ### p#
 # s  #
# s s#
#  ####
# o  o #
# o o  g#
#########