33
    ###
   # g #
 ###olo###
 #o#o  # ##
#o  ooo  k#
# ooo  oo #
##p o  o ##
 #########