33
   #$$$#
   # g #
 #$#   #$#
#$o    $ $#
#o       k#
# o    oo #
$#pgo  o #$
 $$$$$$$$$