35
    ####
   #g   #
  #####l#
  # ee  p#
  #e#e#  #
 ##  see#
#k#e#e# #
#     s #
#########