33
    ####
   #ggg #
  #####l#
  # ee  p#
  #e#e#  #
 ##  see#
#k#e#e# #
#     s #
#########