43
  ###
 # p #
##ooo#
#   k#
 #hq  ##
 #s#oo  #
 #  o s#
  ###lo #
    # g#
     ##