23
   ###
   # g#
 # #lo #
#p#h o #
# # h h#
#s#oooo#
#h h  h#
 #####k#
      #